XXXXXXXXXXX
Xh   b   fX
X         X
X         X
X         X
Xg   A   dX
X         X
X         X
X         X
Xa   c   eX
XXXXXXXXXXX
