XXXXXXXXXXX
Xh   b    X
X         X
X         X
Xa       eX
Xg   A   dX
X         X
X         X
X         X
X    c    X
XXXXXXXXXXX
