XXXXXXXXXXX
XD     k wX
X         X
X         X
X         X
X     a   X
X         X
X    e    X
X         X
X   k    DX
XXXXXXXXXXX