XXXXXXXXXXXXXXXXXXXXX
X f                 X
X                   X
X                   X
X                  aX
X                   X
X                   X
X                   X
X                   X
X   f               X
X                   X
X                   X
Xf                  X
X                   X
X                   X
X                   X
X                   X
X                   X
X        e f        X
XXXXXXXXXXXXXXXXXXXXX