XXXXXXXXXXXXXXXXXXXXX
X f                 X
X                   X
X                   X
X                  aX
X                   X
X                   X
X                   X
X         f         X
X                   X
Xg    e          f  X
X                   X
X                   X
X                   X
X                   X
X                   X
X                   X
X                   X
X         h      f  X
XXXXXXXXXXXXXXXXXXXXX