XXXXXXXXXXXXX
X          wX
X          kX
X           X
X           X
X           X
X     e    kX
X           X
X      k    X
XXXXXXXXXXXXX